{
  "dataKey": "wm_forest",
  "mapName": "The Forest",
  "mapWorldWidth": 3,
  "mapStrings": [
    "111111111100000000100000000100000000100000000100000000100000001",
    "111111111000000000000000000000000000000000000000000000111111111",
    "111111111000000001000000201000000001000000001000000001100000001",
    "100000001100000001100000001100000000100000001100000001100000001",
    "111111111100000001100000001000030000100000001100000001111111111",
    "100000001100000001100000001000000001100000001100000001100000001",
    "100000001100000000100000000100000000100000000100000000111111111",
    "111111111000000000000000000000000000000000000000000000111111111",
    "100000001000000001000000001000000001000000001000000001111111111"              
  ],
  "mapPortals": [
       {"mi": 2, "x": 7, "y": 3, "dataKey": "wm_home", "dmi": 0, "dx": 1, "dy" : 3}
  ],
  "mapWorldUnits" : [
    {
      "mi": 4,
      "type": "player",
      "x": 2,
      "y": 2
    }
  ]
}