{
  "dataKey": "wm_home",
  "mapName": "Home",
  "mapWidth": 9,
  "mapHeight": 7,
  "mapWorldWidth": 3,
  "mapWorldHeight": 3,
  "mapStrings": [
    "111111111100000000100000000100030000100000000100000000100000001",
    "111111111000000000000000000000030000000000000000000000111111111",
    "111111111000000001000000001000030001000000001000000001100000001",
    "100000001100000001100000001100030000100000001100000001100000001",
    "111111111100000001100000001000020000100000001100000001111111111",
    "100000001100000001100000001000030001100000001100000001100000001",
    "100000001100000000100000000100030000100000000100000000111111111",
    "111111111000000000000000000000030000000000000000000000111111111",
    "100000001000000001000000001000030001000000001000000001111111111"              
  ],
  "mapPortals": [
    {"mi": 0, "x": 1, "y": 3, "dataKey": "wm_forest", "dmi": 2, "dx": 6, "dy" : 3}
  ],
  "mapWorldUnits" : [
    {
      "mi": 4,
      "type": "player",
      "x": 2,
      "y": 2
    }
  ],
  "onPlayerDeath": "softMapReset"
}