{
  "mapWorldWidth": 3,
  "mapStrings": [
    "111111111100000000103030000100000000100000000100000000100000001",
    "111111111000000000000000300000000000000000000000000000100100000",
    "111111111000000001000000301000000001000000301000000001000000301",
    "100000001103000001100000000100000001100000001103000001100000001",
    "100100000100111010000001010100101030100100111100100200100100000",
    "000000001000000001000000031000111111111100031000000001000000001",
    "100000001100000001100000001103000000100000000103030000111111111",
    "100100000100000000100000000000000000000000000000000300111111111",
    "000000001000000001000000001000000301000000001000000301111111111"                
  ],
  "mapWorldUnits" : [
    {
      "mi": 4,
      "type": "player",
      "x": 2,
      "y": 2
    }
  ]
}